1111111111111111111
1000C00000001000001
1P0000000100000C001
100000000C000000001
1C00000000000E00001
1111111111111111111