1111111111111111111111111
1000C00000001000000000001
100000000100000C0000000C1
1P00000000000000000000001
1000000000000000011000001
1000000001000000000000001
10000000000000000000000C1
10001100000000C0000E00001
1111111111111111111111111