1111111111111111111111111
1000C00000001000000000001
100000000100000C0000000C1
1P00000000000000000000001
1000000000000000011000001
1000110001000000000000001
100000000000C000000E000C1
1111111111111111111111111